三农问题: 	
中国国家农业信息网: 	北京:S-Ns 中国:S-Ns 
种业硅谷: 	长沙市:B-Ns 芙蓉区:I-Ns 浏阳河:I-Ns 东畔:E-Ns 袁隆平:S-Nh 隆平:S-Nh 
工分制: 	中国:S-Ns 
北京谷物协会: 	北京谷物协会:B-Ni 北京市:I-Ni 农业:I-Ni 技术:I-Ni 推广站:E-Ni 北京市:B-Ni 民政局:E-Ni 北京市:S-Ns 
农村公共物品供给研究: 	石洪斌:S-Nh 
犁牛扬: 	
顾国新: 	顾国新:S-Nh 辽宁:B-Ni 营口:I-Ni 人:I-Ni 全国政协:I-Ni 委员:I-Ni 中华全国供销合作总社:I-Ni 党组:I-Ni 成员:I-Ni 理事会:E-Ni 中国:B-Ni 供销:I-Ni 集团:E-Ni 海南:B-Ni 瑞龙:I-Ni 实业:I-Ni 开发:I-Ni 公司:E-Ni 中国:B-Ni 农业:I-Ni 生产资料:I-Ni 集团公司:E-Ni 
农业部南海区渔政渔港监督管理局: 	农业部:B-Ni 南海区:I-Ni 渔:I-Ni 政局:I-Ni 南海区:I-Ni 渔:I-Ni 政局:I-Ni 南海:I-Ni 渔:E-Ni 中华人民共和国:B-Ni 南海区:I-Ni 渔政:I-Ni 渔港:I-Ni 监督:I-Ni 管理局:E-Ni 广州:S-Ns 中华人民共和国:B-Ni 农业部:E-Ni 南海区:B-Ni 渔业:E-Ni 中华人民共和国国务院:S-Ni 农牧渔业部:S-Ni 农牧渔业部:B-Ni 南海区:I-Ni 渔政:I-Ni 分局:E-Ni 农牧渔业部:B-Ni 南海区:I-Ni 渔业:I-Ni 指挥部:E-Ni 农业部:B-Ni 南海区:I-Ni 渔业:I-Ni 指挥部:E-Ni 农业部:B-Ni 港澳:E-Ni 委员会:B-Ni 农业部:E-Ni 
三自一包: 	刘少奇:S-Nh 毛泽东:S-Nh 
农村税费改革: 	中国:S-Ns 
环球农产品网: 	环球农产品网:B-Ni 北京:I-Ni 桑粱:I-Ni 技术:I-Ni 发展:I-Ni 中心:E-Ni 
农业特产税: 	
生产大队: 	中国:S-Ns 
两田制: 	
社会主义新农村: 	中国:S-Ns 
农业学大寨: 	学雷锋:S-Nh 大寨:S-Ns 
中华人民共和国农业机械化促进法: 	
一亩田: 	北京:B-Ni 一人:I-Ni 一亩田:I-Ni 网络科技:I-Ni 有限公司:E-Ni 一亩田:B-Ni 集团:E-Ni 
中华人民共和国农业机械部: 	中华人民共和国国务院:S-Ni 
新农村建设: 	
中国三农网: 	中国:S-Ns 
中国农业综合开发年鉴2008: 	　:B-Ni 出版社:E-Ni 中国:S-Ns 中国农业综合开发年鉴2008:S-Ns 中国:S-Ns 
屠宰税: 	财政部:S-Ni 国务院:S-Ni 
中国农户网: 	中国:S-Ns 
中国农业生产资料流通协会: 	中国:B-Ni 农资:I-Ni 流通:I-Ni 协会:E-Ni 
