三农问题: 	(三农问题, 指, 农业农村农民三个问题); (行业, 居住, 地域主体身份); (中共十六大后一系列高层会议政策举措, 勾勒, 中央新领导集体施政思路概貌); (新领导集体, 面临, 问题); (以前, 担负, 任务); (担负任务以前相比很大不同施政思路, 展示, 不少新东西); 
中国国家农业信息网: 	(各地分网, 邀请, 协作); (我国三农事业, 发展, 经济社会); (诚信创新高效激情职责, 追求, 　); (三农需求职责政府, 追求, 发展宗旨); (一家, 分, 网); (良好工作成绩丰富实践经验, 具有, 中高级农业专业技术职称个人三农产业化中龙头企事业重点企事业农业农村投资重点企事业政府机构社团具有代表性农民自治组织); (中高级农业专业技术职称个人三农产业化中龙头企事业重点企事业农业农村投资重点企事业政府机构社团, 具有, 代表性农民自治组织); (农业高科技成果, 转化, 农业产业化科技推广产业化辐射全国各地高科技农业产业); (农业产业化科技推广, 产业化, 辐射全国各地高科技); (中国国家农业信息网, 希望, E网平台促进各省地区高科技成果转化); (E网平台, 促进, 各省地区高科技成果转化); (能工巧匠力, 发展, 外向型农业); (专注农业信息化领域, 坚持, 三农服务自有品牌软件专业技术优势雄厚开发力量完善); (服务, 深化, 工作拓展业务形成); (良性发展模式持续性, 提高, 我国农业信息化水平); (良性发展模式持续性提高我国农业信息化水平, 使, 成为全国万千农民走向发家致富磁悬浮列车); (全国万千农民, 走向, 发家致富磁悬浮列车); (中国农民, 发展, 组织化规模化专业化产业); (农业市场, 开放, 坚强后盾); 
种业硅谷: 	(种业硅谷, 位于, 24平方公里); (父, 杂交, 水稻); (杂交水稻父袁隆平名字, 命名, 隆平新区•种业硅谷); 
工分制: 	(中国农村集体经济组织内部计量社员, 参加, 公共生产劳动数量社员劳动报酬一种形式); (一种工作, 要求, 一天达到劳动数量劳动日); (一天, 达到, 劳动数量劳动日); (每个人, 耗费, 分配消费数量); (每一工分值每个人工分总额, 分配, 劳动报酬); 
北京谷物协会: 	(定单销售种植业风险互助行业服务技术咨询方面, 作, 大量工作); 
农村公共物品供给研究: 	
犁牛扬: 	(词条暂无内容, 参与, 编辑); (词条, 规范, 信息); (若有疑问, 欢迎, 联系); (小组, 联系, 友情); (之前, 编写, 内容); 
顾国新: 	
农业部南海区渔政渔港监督管理局: 	(农业部南海区渔政局南海区渔政局南海渔政局, 称, 直属); (			,  , 		); (直属中华人民共和国国务院, 受, 中央军事委员会领导); (1984年5月归属农牧渔业部, 改称, 农牧渔业部南海区渔政分局挂农牧渔业部南海区渔业指挥部牌子); (农牧渔业部南海区渔政分局, 挂, 农牧渔业部南海区渔业指挥部牌子); (珠江流域管理委员会, 成立, 农业部港澳流动渔民工作协调小组); 
三自一包: 	(三自, 指, 主持调整工作恢复大跃进前农村经济政策); (调整工作, 恢复, 大跃进前农村经济政策); (毛泽东, 反对, 包产到户前各级党委多加干预); (包产到户前各级党委, 多加, 干预); 
农村税费改革: 	(农村税费改革, 称为, 建国以来); (中国农村, 继, 土地改革); (之后, 实行, 承包); (第三次重大改革, 看成, 减轻农民负担治本之策); (改革, 引起, 人们关注进行研究); (人们, 关注, 进行研究); (研究, 集中, 迫切需要); (税费改革成效前景, 判断, 争论); 
环球农产品网: 	
农业特产税: 	(农业特产税农业特产农业税, 简称, 国家从事农业特产生产取得收入单位个人征收一项税收); (国家, 从事, 农业特产生产); (国家从事农业特产生产, 取得, 收入单位个人征收一项税收); (收入单位个人, 征收, 一项税收); (国家, 从事, 农业特产生产经营单位个人征收一项税收); (农业特产生产经营单位个人, 征收, 一项税收); (课税目的税制, 来看, 农业特产税特点相对独立性农业税较大区别); 
生产大队: 	(生产大队大队, 指, 中国大陆农村地区人民公社时期存在农村基层组织); (中国大陆农村地区人民公社时期, 存在, 农村基层组织); (前身行政村, 实行, 人民公社制度); (大队建制上公社, 管辖, 行政编组行政区生产预算单位); (其下, 划分, 生产队生产队); 
两田制: 	(集体土地, 划分, 口粮田责任田地方商品田经济田两部分); 
社会主义新农村: 	(中国, 提出, 建设社会主义新农村小康社会重要内容); (五中全会所提建设社会主义新农村新历史背景中全新理念, 指导, 下一次农村综合变革新起点); 
农业学大寨: 	(农业学大寨, 树立, 奉献); (宣传语境中大寨事迹, 切合, 需要); 
中华人民共和国农业机械化促进法: 	(农民农业生产组织, 使用, 先进适用农业机械); (建设现代农业, 制定, 本法); 
一亩田: 	(国内大型农产品B2B诚信交易平台一端服务批发商, 采购商, 另一端); (服务农民产地移动互联网大数据能力, 改善, 流通方式指导农业生产); (流通方式, 指导, 农业生产); (社会资源农民, 增收, 减负目的); 
中华人民共和国农业机械部: 	
新农村建设: 	(贯彻落实科学发展观重大举措, 建设, 社会主义新农村); (科学发展观重要内容经济社会, 协调, 重要组成部分); (全面落实科学发展观, 保证, 占人口大多数农民参与发展进程); (人口大多数农民, 参与, 发展进程); (发展, 协调, 科学发展观); (建设社会主义新农村, 落实, 科学发展观); (科学, 发展, 轨道); 
中国三农网: 	(中国三农网中国泛家居行业领航者亚太传媒, 结合, 三农问题政策亲情); (三农网, 关心, 农业增长关注); (农业, 增长, 关注); (农村稳定农民, 增收, 提供农业资讯农产品价格行情农业信息技术推动建设); (农业资讯农产品价格行情农业信息技术, 推动, 建设); 
中国农业综合开发年鉴2008: 	(			,  , 	); (1版,  , 2009年2月1日中国农业综合开发年鉴2008精装583页); (			,  , 		); (　　中国农业综合开发年鉴2008内容丰富全面系统地, 记述, 2007年全国农业开发工作收集); (详实农业综合开发统计数据广大读者, 了解, 研究农业综合开发基层农业综合开发工作者全面学习农业综合开发业务规范统计数据提供一份难得资料); (综合开发基层农业综合开发工作者, 研究, 农业); (研究农业综合开发基层农业综合开发工作者全面学习农业综合开发业务规范统计数据, 提供, 一份难得资料); (新阶段农业综合开发工作, 建设, 小康社会); (建设, 发挥, 更大作用); 
屠宰税: 	(屠宰税屠宰牲畜单位个人, 征收, 一种税收); (具体征收办法, 制定, 报国务院备案); 
中国农户网: 	(未来窗口农户, 创造财富, 家园); 
中国农业生产资料流通协会: 	(中国农业生产资料流通协会, 简称, 中国农资流通协会中华全国供销合作总社主管); (全国, 从事, 农业生产资料流通企事业单位相关部门); (组织, 推动, 作用); 
